88888888888888888888888888888888888888888888888888888888888888888888888888888888888888888
8                                                                                       8
8                                                                                       8
8                                                                                       8
8       B      A     C       =                                                          8
8 888888888888888888888888888888888888888888888888888888888888888888888888888888888888888                                                                                      8
8                                                                                       8
8                                                                                       8
8  1      A        B       C      =                                                     8
88888888888888888888888888888888888888888888888888888888888888888888888888888888888888888