88888888888888888888888888888888888888888888888888888888888888888888888888888888888888888
8                                                                                       8
8                                                                                       8
8                                                                                       8
8         =   O    G     D                                                                8
8      888888888888888888888888888888888888888888888888888                              8
8                                                                                       8
8 888                                                                                   8
8  1    =                 O      D      G         =                                     8
88888888888888888888888888888888888888888888888888888888888888888888888888888888888888888