88888888888888888888888888888888888888888888888888888888888888888888888888888888888888888
8                                                                                       8
8                                                                                       8
8                                            =                                          8
8                                 c         888                                         8
8                      b         888                                                    8
8         a           888                                                               8
8        888                                                                            8
8  1                                                                                    8
88888888888888888888888888888888888888888888888888888888888888888888888888888888888888888