88888888888888888888888888888888888888888888888888888888888888888888888888888888888888888
8                                                                                       8
8                                                                                       8
8                                                                                       8
8       A         B         C                                                           8
8           =                                                                            8
8 888888888888888888888888888888888888888888888888888888888888888888888888888888888888888
8    A  A      B    C                           8
8  1      a                                                                            8
88888888888888888888888888888888888888888888888888888888888888888888888888888888888888888