88888888888888888888888888888888888888888888888888888888888888888888888888888888888888888
8                                                                                       8
8                                                                                       8
8                                                                                       8
8                                                                                       8
8                                                                                       8
8                                                                                       8
8   a  b  c                                                                             8
8                 =                                                                     8
88888888888888888888888888888888888888888888888888888888888888888888888888888888888888888