88888888888888888888888888888888888888888888888888888888888888888888888888888888888888888
8                                                                                       8
8                                                                                       8
8                                                                                       8
8                                                                                       8
8     AP          EL     PE         =                                                   8
8    888         888    88888       888                                                8
8        888                                                                            8
8  1             E      A      P      L    =                                            8
88888888888888888888888888888888888888888888888888888888888888888888888888888888888888888