88888888888888888888888888888888888888888888888888888888888888888888888888888888888888888
8     I t  =                                                                            8
8                                                                                       8
8                                                                                       8
8         888                                                                           8
8                 T      I         =                 =    I        RD           ET      8
8          R   888    88888       888      8888      88888888    8888888    8888888     8
8        888                                                                            8
8         D     E          =             T            E                =            1   8
88888888888888888888888888888888888888888888888888888888888888888888888888888888888888888