BBBBBBBBBBBBBBBBbBbbbbbbbbbbbbbbbb
B---3--4---M---2----c------P---5-b
B--5----6---1----9--E-----3---M--b
B--1---d--C-7---8----6-----D---S-B
B---0------9-----c---4------1----B
B--2----4--S---P---8---0---e---7-B
BbBbbbbbbbbbbbbbbBbbbbbbbbbbbbbbbb