BBBBBBBBBBBBBBBB
B--------------b
B---------1----b
B---1----------b
B--------------B
B---1------1---B
B--------------B
BbBbbbbbbbbbbbbb