BBBBBBBBBBBBBBBBbBbbbbbbbbbbbbbbbb
B---123-----   456------789------b
B---123-----   456------789------b
B------ PPP----000---SSS---------B
B-------mmm----------ddd---------B
B------cc--------------ee--------B
BbBbbbbbbbbbbbbbbBbbbbbbbbbbbbbbbb