BBBBBBBBBBBBBBBBbBbbbbbbbbbbbbbbbb
B---123-----   456------789------b
B---123-----   456------789------b
B------ PPP----000---SSS---------B
B--------mm----------MM----------B
B------cc--------------ee--------B
BbBbbbbbbbbbbbbbbBbbbbbbbbbbbbbbbb