BBBBBBBBBBBBBBB--BBBBBBBBBBBBBB
B----------------B--------------
B----------------B--------------
B--------BBBBBB--B--------BBBBBB
B------------=B--B------------=B
B-------------B--B-------------B
B-------------B--B-------------B
BbBbbbbbbbbbbb---BbBbbbbbbbbbbb-