BBBBBBBBBBBBBBBB
B--------------b
B---------0----b
B---1----------b
B--------------B
B---0------1---B
B--------------B
BbBbbbbbbbbbbbbb