BBBBBBBBBBBBBBBB
B--------------b
B---------0----b
B---G----------b
B--------------B
B---0------G---B
B--------------B
BbBbbbbbbbbbbbbb