BBBBBBBBBBBBBBBB--BBBBBBBBBBBBBBB
B-----------------B---------------
B-----------------B---------------
B---------BBBBBB--B---------BBBBBB
B-------------=B--B-------------=B
B--------------B--B--------------B
B--------------B--B--------------B
BbBbbbbbbbbbbbb---BbBbbbbbbbbbbbb-