BBBBBBBBBBBBBBBBbBbbbbbbbbbbbbbb-b
B---3--4-----------c------P------b
B--5----6------------------M-----b
B---------7---8---------D----S---B
B---0------9-----c---------1-----B
B---------------------=ee--------B
BbBbbbbbbbbbbbbbbBbbbbbbbbbbbbbbbb