BBBBBBBBBBBBBBBBbBbbbbbbbbbbbbbbbb
B---8----2-----4-----3-----5-----b
B-----1-----6-----9-----7----0---b
B---sp------dm----pd-------sm----B
B---dp------ms----ds-------mp----B
B---Ce------eC----CE-------Ec----B
BbBbbbbbbbbbbbbbbBbbbbbbbbbbbbbbbb